000000000000000
011111111111110
013333322333310
013131313131210
012223333232310
013121313121210
013333333223210
013121313131310
013333333333310
013121313131310
013333333333310
011111111111110
000000000000000